0000000000000000000000000
0000000000000000000000000
00000000000000T0000000000
0000000000001111110001000
0000000000001111100001000
0000000000000000000001111
0000000000000000000011111
0000000000000000010000000
0000000000000000010000000
0000000000000L00010000000
0000000000001111110000000
0000000000111111110000000
0001000011100000000000000
0001000000000000000000000
0001000000000000000000000
0001111110000000000000000
0001111111000010000000000
100000000000L010000000000
1000000000001110000000000
0000000000000000000000000
00001111111000L0000000000
000011111111011000L000000
0000000000000000001000000
0000P00000000000001000000
00000000110000S0001000000
1111001111011111111111111
1111111111111111111111111
