00000000000000000000000000000000000000000000000000000000000
00000000000000000000000000000000000000000000000000000000000
0000P000000000000000000000000000000000000000000000000000000
000000000000000000000L0000000000000000000000000000000000000
00011111111000111111110000000000000000000000000000000000000
00011111111000000000000010000000000000000000000000000000000
0000000000000000000000001000000000000000000000000000T000000