0000000000000000000000000
0000000000000000000000000
0000000000000000001000000
0000P00000000000001000000
0000000011100000001000000
1111111111111111111111111
0000011111111111110000000
0000000000000000000000000